11111111111111111111111111111111111
10000000000000000000000000000000001
10000V00000000000000000000000000001
10000000000000000000000000000000001
10000000000P0000000000000000000GG01
10000000000000000000000000000000001
10000G000000000000000000000000000G1
10000000000000000000000000000000001
100000000000009000000000000000000G1
10000000000000000000000000000000001
100000V00000000000000000V0000000001
111111111111111100001111111111111111
10000000000000000000000000000000001
10000000000000000000000000000000001
10000000000P000000000000000000000G1
10000000000000Y00000000000000000001
10000000000000000000000000000000001
10000000000V0000000000000G0000000G1
10000000000000000000000000000000001
10000000000000000000000V00000000001
10000000000000H000000000000000000G1
111111111111111D11111111111111111111
