11111111111111111111111111111111111
10000000000000000000000000000000001
10000000000000000G00000000000000001
10000000000000000000000G0000000001
1000000000000000V000000000000000001
10000000000000009000000000000000001
10000000000000000V00G00000000000001
100000000000000000000000G0000000001
100000000000P00000000000000G0000001
10000000000000G000000000000G0000001
100000000000000000000G0000000G0001
11111111111111100000111111111111111
1000000000000000Y000000000000000001
10000000000P00000H000000V00G0000001
1000000000000000000V000000000000001
1000000000000000000000G000G00000001
10000000000000000000000000000000001
100000000000000000000G00000G0000001
10000000000000000000000000000000001
22222222222222223332222222222222222
23333333333333333333333333333333332
23222222222222223332222222222222332
23333333333333333333333333333332332
23222222322222223332222222222322332
23233332333333333333333333332333332
23232322222222222222222222222322332
23233333333333P33333333333333322332
23222222222222222222222222223322332
23333333333333333333333333333322332
2322222222222222222222222222233D332
22222222222222222222222222222222222

