11111111111111111111111111111111111
10000000000000000000000000000000001
10000V000000000T000000000000000GG01
10000000000000000000000G00000000001
10000000000P0000000000000000000GG01
10000000000000000000000000000000001
10000000000000090000000000000000001
10000000000000000000000000000000001
10000000G0000000000000V0000000000G1
10000000000000000000000000000000001
10000V0000000000T00000000000000GG01
111111111111111100001111111111111111
10000000000000000000000000000000001
10000000000000G00000000000000000001
10000000000P000000000000000000000G1
10000000000000Y0000000000V000000001
10000000000H000000G00000000000000G1
10000000T000000000000000G000000GG01
10000000000000000000G000000000000G1
10000000000000M0000000000000000GG01
10000000000000000000000000000000001
111111111111111D11111111111111111111
