11111111111111111111111111111111111
1P00000001110000001110000000000P001
1000V0000111000V0011100000V00000001
10000000001110000001110000000000001
10000000000000000000000000000000001
11111100000000P00000000001111111111
10000000000000000000000000000000001
10000000000000000000000000000000001
10000000000000900000000000000000001
10000000000000000000000000000000001
10000000000000Y00000000000000000001
11111100000000000000000001111111111
10000000000000P00000000000000000001
100000V00000000000000000V0000000001
10000000000000000000000000000000001
1P000000000000000000000000000000P01
10000000000000000000000000000000001
10000000000000H00000000000000000001
1000000000000000000000000000000G001
11111111100000000000001111111111111
12222220000000P00000000022222222221
12222220000000000000000002222222221
12333220000000000000000002333322221
12333220000000V00000000002333322221
12333220000000000000000002333322221
12222220000000000000000002222222221
12222220000000P00000000002222222221
12222222222222222222222222222222D21
11111111111111111111111111111111111
