11111111111111111111111111111111111
10000000000000000000000000000000001
10000000000000000000000000000000001
10000000000000000000000000000000001
10000000000000000000000000000000001
100000000000P000900000V000000000001
10000000000000V00000000000000000001
100000000000000000000000000G0000001
100000000000000P00000000000000G0001
100000000000000000000000000G0000001
100000000000000000000G00000000G0001
11111111111111100000111111111111111
10000000000000000000000000000000001
10000000000000000H0000000VG0000001
1000000000000000V000000000000000001
10000000000P0000V00000000000G000001
10000000000000000000000000000000001
10000000000000000000000000000000001
10000000000000000000000000000000001
22222222222222223332222222222222222
23333333333333333333333333333333332
23222222222222223332222222222222332
23333333333333333333333P33333V2332
23222222322222223332222222222322332
23233332333333333333333333332333332
23232322222222222222222222222322332
23233333333333P33333333333333322332
23222222222222222222222222223322332
23333333333333333333333333333322332
2322222222222222222222222222233D332
22222222222222222222222222222222222

